████████████████████████████
█  █       █      █        █
█  ████    █  █   █    █   █
█  █  █  ███  █  ████  █   █
█  █  █    █  █     █  █   █
█  █       █  ████  █  █   █
█      █████        █      █
█                          █
█████████████   █████      █
█  █                █  █████
█  █  █   ████████  █      █
█  █  █             █████  █
█  █  ███████████          █
█X        █           █    █
████████████████████████████