█████████████████████████████
██ 0█       █      █  Θ     █
██  ████    █  █   █    █   █
██  █  █  ███  █  ████  █   █
██  █  █    █  █     █  █   █
██  █     Θ █  ████  █  █   █
██      █████        █      █
██                          █
██████████████   █████      █
██  █                █  █████
██  █  █   ████████  █      █  
██  █  █             █████  █
██  █  ███████████          █
██X        █           █    █
█████████████████████████████